15 15
WWWWWWGooWWWWWW
W.............W
WoWWWWWoWWWWWoW
W...W.....W...W
WoooWoooooWoooW
W.............W
WoooWCCCCCCCWoW
....W....KW....
ooooWWWWWWWoooo
.P.............
WoWWWWWoooooooW
W.....W.......W
WoWWWoooooooooW
W.............W
WWWWWWoooWWWWWW
