15 15
WWWWWWoKoWWWWWW
W.............W
WoooooooWWWWWoW
W.........W...W
WooPoooWWWWoooW
W.............W
WoooWooooWooooW
....WCCCCW.....
ooooWWWWWWooooo
...............
WooWWWooooooooW
W..W..........W
WoWWooooooooooW
W.............W
WWWWWWoGoWWWWWW
